{
  "field_size": 10,
  "initial_snake_length": 3,

  "rewards": {
    "timestep": -10,
    "ate_fruit": 100,
    "died": -1000
  },

  "field": [
    "##########",
    "#........#",
    "#........#",
    "#........#",
    "#....S...#",
    "#........#",
    "#........#",
    "#........#",
    "#........#",
    "##########"
  ]
}